TTTDDDDDDDDDDDDDDTTT
TTTWWWWGGGGGGWWWWTTT
TTTDDDDDSSSSDDDDDTTT
DZDDDDDDSSSSDDDDDDZD
DZDMMMMMDDDDMMMMMDZD
DZDMDMDMDMMDDMDDMDZD
DZDMDMDDDDMMDMDMMDZD
DZDMDDDDMDMDDDDDMDZD
DZDMDMMMMDMDMMMMMDZD
DZDMDDDMMMMDDMMDMDZD
DZDMDMDMDDDMDMDDMDZD
DZDMDMMMDDDMMMDMMDZD
DZDMDDDMDDDDDDDDMDZD
DZDMDMMMMDMMMMMMMDZD
DZDMDMMMDDDMDDDMMDZD
DZDMDDDDDMDDDMDDMDZD
DZDMMMMMMMMMMMMMMDZD
TTTDDDDDDDDDDDDDDTTT
TTTWWWWWWWWWWWWWWTTT
TTTDDDDDDDDDDDDDDTTT
