GGGDDDDDDDDDDDDDDGGG
GTGWWWWGGGGGGWWWWGTG
GGGDDDDDSSSSDDDDDGGG
DZDDDDDDDDDDDDDDDDZD
DZDMMMMMDDDDMMMMMDZD
DZDMDMDMDMMDDMDDMDZD
DZDMDMDDDDMMDMDMMDZD
DZDMDDDDMDMDDDDDMDZD
DZDMDMMMMDMDMMMMMDZD
DZDMDDDMMMMDDMMDMDZD
DZDMDMDMDDDMDMDDMDZD
DZDMDMMMDDDMMMDMMDZD
DZDMDDDMDDDDDDDDMDZD
DZDMDMMMMDMMMMMMMDZD
DZDMDMMMDDDMDDDMMDZD
DZDMDDDDDMDDDMDDMDZD
DZDMMMMMMMMMMMMMMDZD
GGGDDDDDDDDDDDDDDGGG
GTGWWWWWWWWWWWWWWGTG
GGGDDDDDDDDDDDDDDGGG
