TGGDDDDDDDDDDDDDDTGG
GGWWWWWGGGGGGWWWWWGG
GZGDDDDDSSSSDDDDDGZG
DZDDDDDDDDDDDDDDDDZD
DZDMMMMMDDDDMMMMMDZD
DZDMDMDMDMMDDMDDMDZD
DZDMDMDDDDMMDMDMMDZD
DZDMDDDDMDMDDDDDMDZD
DZDMDMMMMDMDMMMMMDZD
DZDMDDDMMMMDDMMDMDZD
DZDMDMDMDDDMDMDDMDZD
DZDMDMMMDDDMMMDMMDZD
DZDMDDDMDDDDDDDDMDZD
DZDMDMMMMDMMMMMMMDZD
DZDMDMMMDDDMDDDMMDZD
DZDMDDDDDMDDDMDDMDZD
DZDMMMMMMMMMMMMMMDZD
TZGDDDDDDDDDDDDDDTZG
GGWWWWWWWWWWWWWWWWGG
GGGDDDDDDDDDDDDDDGGG
