GGGGGGGGGGGGGGGGGGGGGGGG
GGGGGGGGGGGGGGGGGGGGGGGG
GGTnnDDDDDDDDDDDDDDTnnGG
GGnnWWWWWRnnLnnWWWWWnnGG
GGnZGDDDDDSSSSDDDDDGZnGG
GGDZDDDDDDDDDDDDDDDDZDGG
GGDZDMMMMMDDDDMMMMMDZDGG
GGDZDMDMDMDMMDDMDDMDZDGG
GGDZDMDMDDDDMMDMDMMDZDGG
GGDZDMDDDDMDMDDDDDMDZDGG
GGDZDMDMMMMDMDMMMMMDZDGG
GGDZDMDDDMMMMDDMMDMDZDGG
GGDZDMDMDMDDDMDMDDMDZDGG
GGDZDMDMMMDDDMMMDMMDZDGG
GGDZDMDDDMDDDDDDDDMDZDGG
GGDZDMDMMMMDMMMMMMMDZDGG
GGDZDMDMMMDDDMDDDMMDZDGG
GGDZDMDDDDDMDDDMDDMDZDGG
GGDZDMMMMMMMMMMMMMMDZDGG
GGTZGDDDDDDDDDDDDDDTZnGG
GGnnWWWWWWWWWWWWWWWWnnGG
GGGGGDDDDDDDDDDDDDDGGGGG
GGGGGGGGGGGGGGGGGGGGGGGG
GGGGGGGGGGGGGGGGGGGGGGGG