GGGGGGGGGGGGGGGGGGGGGGGG
GGGGGGGGGGGGGGGGGGGGGGGG
GGTGGGGGGGGGGGGGGGGTGGGG
GGGGWWWWWRnnLnnWWWWWGGGG
GGnZDDDDDSSSSSSDDDDDZnGG
GGGZDDDDDDDDDDDDDDDDZGGG
GGGZDMMMMMDDDDMMMMMDZGGG
GGGZDMDMDMDMMDDMDDMDZGGG
GGGZDMDMDDDDMMDMDMMDZGGG
GGGZDMDDDDMDMDDDDDMDZGGG
GGGZDMDMMMMDMDMMMMMDZGGG
GGGZDMDDDMMMMDDMMDMDZGGG
GGGZDMDMDMDDDMDMDDMDZGGG
GGGZDMDMMMDDDMMMDMMDZGGG
GGGZDMDDDMDDDDDDDDMDZGGG
GGGZDMDMMMMDMMMMMMMDZGGG
GGGZDMDMMMDDDMDDDMMDZGGG
GGGZDMDDDDDMDDDMDDMDZGGG
GGGZDMMMMMMMMMMMMMMDZGGG
GGTZnDDDDDDDDDDDDDDTZGGG
GGGGWWWWWWWWWWWWWWWWGGGG
GGGGGGGGGGGGGGGGGGGGGGGG
GGGGGGGGGGGGGGGGGGGGGGGG
GGGGGGGGGGGGGGGGGGGGGGGG